org,year,total_appointments,unique_appointments,new_appointments,reappointment_count,rate_per_total_appointments,rate_per_unique_appointment,reappointment_to_new_ratio,rate_bucket
Aboriginal Affairs Secretariat,2018,4,4,4,0,0.0,0.0,0.0,"(-0.001, 10.0]"
"Agriculture, Aquaculture and Fisheries",2013,20,17,20,0,0.0,0.0,0.0,"(-0.001, 10.0]"
"Agriculture, Aquaculture and Fisheries",2014,26,17,19,7,26.92,0.412,0.368,"(20.0, 30.0]"
"Agriculture, Aquaculture and Fisheries",2015,1,1,1,0,0.0,0.0,0.0,"(-0.001, 10.0]"
"Agriculture, Aquaculture and Fisheries",2018,33,31,31,2,6.06,0.065,0.065,"(-0.001, 10.0]"
"Agriculture, Aquaculture and Fisheries",2019,2,2,2,0,0.0,0.0,0.0,"(-0.001, 10.0]"
"Agriculture, Aquaculture and Fisheries",2021,26,21,18,8,30.77,0.381,0.444,"(30.0, 40.0]"
"Agriculture, Aquaculture and Fisheries",2022,9,9,6,3,33.33,0.333,0.5,"(30.0, 40.0]"
"Agriculture, Aquaculture and Fisheries",2023,20,20,19,1,5.0,0.05,0.053,"(-0.001, 10.0]"
"Agriculture, Aquaculture and Fisheries",2024,11,10,0,11,100.0,1.1,,"(90.0, 100.0]"
Board of Management,2014,7,7,7,0,0.0,0.0,0.0,"(-0.001, 10.0]"
Economic Development,2013,9,9,9,0,0.0,0.0,0.0,"(-0.001, 10.0]"
Economic Development,2014,15,15,14,1,6.67,0.067,0.071,"(-0.001, 10.0]"
Economic Development,2015,12,11,12,0,0.0,0.0,0.0,"(-0.001, 10.0]"
Education and Early Childhood Development,2014,16,16,16,0,0.0,0.0,0.0,"(-0.001, 10.0]"
Education and Early Childhood Development,2016,2,2,1,1,50.0,0.5,1.0,"(40.0, 50.0]"
Education and Early Childhood Development,2017,15,15,15,0,0.0,0.0,0.0,"(-0.001, 10.0]"
Education and Early Childhood Development,2018,1,1,0,1,100.0,1.0,,"(90.0, 100.0]"
Education and Early Childhood Development,2019,1,1,0,1,100.0,1.0,,"(90.0, 100.0]"
Education and Early Childhood Development,2020,13,11,11,2,15.38,0.182,0.182,"(10.0, 20.0]"
Education and Early Childhood Development,2021,1,1,1,0,0.0,0.0,0.0,"(-0.001, 10.0]"
Education and Early Childhood Development,2022,1,1,1,0,0.0,0.0,0.0,"(-0.001, 10.0]"
Education and Early Childhood Development,2024,17,17,16,1,5.88,0.059,0.062,"(-0.001, 10.0]"
Elections New Brunswick,2013,49,48,49,0,0.0,0.0,0.0,"(-0.001, 10.0]"
Elections New Brunswick,2014,5,5,5,0,0.0,0.0,0.0,"(-0.001, 10.0]"
Elections New Brunswick,2015,15,15,15,0,0.0,0.0,0.0,"(-0.001, 10.0]"
Elections New Brunswick,2016,1,1,1,0,0.0,0.0,0.0,"(-0.001, 10.0]"
Elections New Brunswick,2018,4,4,4,0,0.0,0.0,0.0,"(-0.001, 10.0]"
Elections New Brunswick,2019,15,15,10,5,33.33,0.333,0.5,"(30.0, 40.0]"
Elections New Brunswick,2020,1,1,1,0,0.0,0.0,0.0,"(-0.001, 10.0]"
Energy Efficiency and Conservation Agency of New Brunswick,2014,5,5,5,0,0.0,0.0,0.0,"(-0.001, 10.0]"
Energy and Mines,2013,6,6,6,0,0.0,0.0,0.0,"(-0.001, 10.0]"
Energy and Mines,2014,10,8,10,0,0.0,0.0,0.0,"(-0.001, 10.0]"
Energy and Mines,2015,7,6,7,0,0.0,0.0,0.0,"(-0.001, 10.0]"
Energy and Resource Development,2016,4,1,1,3,75.0,3.0,3.0,"(70.0, 80.0]"
Energy and Resource Development,2017,2,2,2,0,0.0,0.0,0.0,"(-0.001, 10.0]"
Energy and Resource Development,2018,13,13,13,0,0.0,0.0,0.0,"(-0.001, 10.0]"
Energy and Resource Development,2019,17,15,17,0,0.0,0.0,0.0,"(-0.001, 10.0]"
Energy and Resource Development; Finance,2017,7,7,7,0,0.0,0.0,0.0,"(-0.001, 10.0]"
Environment and Local Government,2013,16,14,15,1,6.25,0.071,0.067,"(-0.001, 10.0]"
Environment and Local Government,2014,17,17,17,0,0.0,0.0,0.0,"(-0.001, 10.0]"
Environment and Local Government,2015,6,6,6,0,0.0,0.0,0.0,"(-0.001, 10.0]"
Environment and Local Government,2016,14,14,14,0,0.0,0.0,0.0,"(-0.001, 10.0]"
Environment and Local Government,2017,23,23,22,1,4.35,0.043,0.045,"(-0.001, 10.0]"
Environment and Local Government,2018,12,12,12,0,0.0,0.0,0.0,"(-0.001, 10.0]"
Environment and Local Government,2019,16,16,13,3,18.75,0.188,0.231,"(10.0, 20.0]"
Environment and Local Government,2020,13,12,12,1,7.69,0.083,0.083,"(-0.001, 10.0]"
Environment and Local Government,2021,26,24,22,4,15.38,0.167,0.182,"(10.0, 20.0]"
Environment and Local Government,2022,8,7,6,2,25.0,0.286,0.333,"(20.0, 30.0]"
Environment and Local Government,2023,18,17,15,3,16.67,0.176,0.2,"(10.0, 20.0]"
Environment and Local Government,2024,16,14,12,4,25.0,0.286,0.333,"(20.0, 30.0]"
Executive Council Office,2013,45,32,45,0,0.0,0.0,0.0,"(-0.001, 10.0]"
Executive Council Office,2014,25,18,23,2,8.0,0.111,0.087,"(-0.001, 10.0]"
Executive Council Office,2015,24,17,24,0,0.0,0.0,0.0,"(-0.001, 10.0]"
Executive Council Office,2016,50,39,47,3,6.0,0.077,0.064,"(-0.001, 10.0]"
Executive Council Office,2017,99,82,87,12,12.12,0.146,0.138,"(10.0, 20.0]"
Executive Council Office,2018,79,48,65,14,17.72,0.292,0.215,"(10.0, 20.0]"
Executive Council Office,2019,107,100,97,10,9.35,0.1,0.103,"(-0.001, 10.0]"
Executive Council Office,2020,84,52,74,10,11.9,0.192,0.135,"(10.0, 20.0]"
Executive Council Office,2021,32,31,31,1,3.12,0.032,0.032,"(-0.001, 10.0]"
Executive Council Office,2022,68,51,56,12,17.65,0.235,0.214,"(10.0, 20.0]"
Executive Council Office,2023,58,50,40,18,31.03,0.36,0.45,"(30.0, 40.0]"
Executive Council Office,2024,71,45,69,2,2.82,0.044,0.029,"(-0.001, 10.0]"
Finance,2013,5,5,5,0,0.0,0.0,0.0,"(-0.001, 10.0]"
Finance,2014,4,4,4,0,0.0,0.0,0.0,"(-0.001, 10.0]"
Finance,2015,8,6,8,0,0.0,0.0,0.0,"(-0.001, 10.0]"
Finance,2016,8,8,8,0,0.0,0.0,0.0,"(-0.001, 10.0]"
Finance,2017,10,10,10,0,0.0,0.0,0.0,"(-0.001, 10.0]"
Finance,2018,11,11,11,0,0.0,0.0,0.0,"(-0.001, 10.0]"
Finance,2019,1,1,1,0,0.0,0.0,0.0,"(-0.001, 10.0]"
Finance,2022,1,1,1,0,0.0,0.0,0.0,"(-0.001, 10.0]"
Finance and Treasury Board,2019,5,5,5,0,0.0,0.0,0.0,"(-0.001, 10.0]"
Finance and Treasury Board,2020,15,15,15,0,0.0,0.0,0.0,"(-0.001, 10.0]"
Finance and Treasury Board,2021,17,17,14,3,17.65,0.176,0.214,"(10.0, 20.0]"
Finance and Treasury Board,2022,10,10,9,1,10.0,0.1,0.111,"(-0.001, 10.0]"
Finance and Treasury Board,2023,15,15,8,7,46.67,0.467,0.875,"(40.0, 50.0]"
Finance and Treasury Board,2024,5,5,5,0,0.0,0.0,0.0,"(-0.001, 10.0]"
Finance; New Brunswick Liquor Corporation,2013,4,4,4,0,0.0,0.0,0.0,"(-0.001, 10.0]"
Finance; New Brunswick Liquor Corporation,2017,10,9,10,0,0.0,0.0,0.0,"(-0.001, 10.0]"
Finance; Transportation and Infrastructure,2017,2,2,2,0,0.0,0.0,0.0,"(-0.001, 10.0]"
Finance; Treasury Board,2019,8,8,8,0,0.0,0.0,0.0,"(-0.001, 10.0]"
Government Services,2013,2,2,2,0,0.0,0.0,0.0,"(-0.001, 10.0]"
Government Services,2015,3,3,3,0,0.0,0.0,0.0,"(-0.001, 10.0]"
Health,2013,27,26,26,1,3.7,0.038,0.038,"(-0.001, 10.0]"
Health,2014,18,17,18,0,0.0,0.0,0.0,"(-0.001, 10.0]"
Health,2015,18,18,18,0,0.0,0.0,0.0,"(-0.001, 10.0]"
Health,2016,39,38,35,4,10.26,0.105,0.114,"(10.0, 20.0]"
Health,2017,26,26,21,5,19.23,0.192,0.238,"(10.0, 20.0]"
Health,2018,22,22,14,8,36.36,0.364,0.571,"(30.0, 40.0]"
Health,2019,32,31,26,6,18.75,0.194,0.231,"(10.0, 20.0]"
Health,2020,17,17,15,2,11.76,0.118,0.133,"(10.0, 20.0]"
Health,2021,27,26,27,0,0.0,0.0,0.0,"(-0.001, 10.0]"
Health,2022,20,20,17,3,15.0,0.15,0.176,"(10.0, 20.0]"
Health,2023,21,20,21,0,0.0,0.0,0.0,"(-0.001, 10.0]"
Health,2024,22,22,17,5,22.73,0.227,0.294,"(20.0, 30.0]"
Healthy and Inclusive Communities,2013,1,1,1,0,0.0,0.0,0.0,"(-0.001, 10.0]"
Healthy and Inclusive Communities,2014,10,10,10,0,0.0,0.0,0.0,"(-0.001, 10.0]"
Healthy and Inclusive Communities,2015,2,2,2,0,0.0,0.0,0.0,"(-0.001, 10.0]"
Indigenous Affairs,2023,1,1,1,0,0.0,0.0,0.0,"(-0.001, 10.0]"
Intergovernmental Affairs,2018,2,2,2,0,0.0,0.0,0.0,"(-0.001, 10.0]"
Intergovernmental Affairs,2021,3,3,3,0,0.0,0.0,0.0,"(-0.001, 10.0]"
Intergovernmental Affairs,2022,1,1,1,0,0.0,0.0,0.0,"(-0.001, 10.0]"
Intergovernmental Affairs,2024,2,2,2,0,0.0,0.0,0.0,"(-0.001, 10.0]"
Justice,2013,3,3,3,0,0.0,0.0,0.0,"(-0.001, 10.0]"
Justice,2014,144,140,144,0,0.0,0.0,0.0,"(-0.001, 10.0]"
Justice,2015,61,60,46,15,24.59,0.25,0.326,"(20.0, 30.0]"
Justice,2016,9,8,9,0,0.0,0.0,0.0,"(-0.001, 10.0]"
Justice and Attorney General,2013,30,27,28,2,6.67,0.074,0.071,"(-0.001, 10.0]"
Justice and Attorney General,2018,7,2,6,1,14.29,0.5,0.167,"(10.0, 20.0]"
Justice and Attorney General,2019,16,16,16,0,0.0,0.0,0.0,"(-0.001, 10.0]"
Justice and Attorney General,2020,7,7,7,0,0.0,0.0,0.0,"(-0.001, 10.0]"
Justice and Attorney General; Public Safety,2020,6,6,6,0,0.0,0.0,0.0,"(-0.001, 10.0]"
Justice and Public Safety,2016,29,29,29,0,0.0,0.0,0.0,"(-0.001, 10.0]"
Justice and Public Safety,2017,94,94,94,0,0.0,0.0,0.0,"(-0.001, 10.0]"
Justice and Public Safety,2018,31,19,31,0,0.0,0.0,0.0,"(-0.001, 10.0]"
Justice and Public Safety,2020,21,20,21,0,0.0,0.0,0.0,"(-0.001, 10.0]"
Justice and Public Safety,2021,31,26,26,5,16.13,0.192,0.192,"(10.0, 20.0]"
Justice and Public Safety,2022,13,10,13,0,0.0,0.0,0.0,"(-0.001, 10.0]"
Justice and Public Safety,2023,15,10,15,0,0.0,0.0,0.0,"(-0.001, 10.0]"
Justice and Public Safety,2024,55,50,54,1,1.82,0.02,0.019,"(-0.001, 10.0]"
Natural Resources,2013,11,11,11,0,0.0,0.0,0.0,"(-0.001, 10.0]"
Natural Resources,2014,9,9,9,0,0.0,0.0,0.0,"(-0.001, 10.0]"
Natural Resources,2015,5,5,5,0,0.0,0.0,0.0,"(-0.001, 10.0]"
Natural Resources and Energy Development,2020,9,9,9,0,0.0,0.0,0.0,"(-0.001, 10.0]"
Natural Resources and Energy Development,2021,9,9,9,0,0.0,0.0,0.0,"(-0.001, 10.0]"
Natural Resources and Energy Development,2022,11,10,11,0,0.0,0.0,0.0,"(-0.001, 10.0]"
Natural Resources and Energy Development,2023,7,6,6,1,14.29,0.167,0.167,"(10.0, 20.0]"
Natural Resources and Energy Development,2024,17,17,14,3,17.65,0.176,0.214,"(10.0, 20.0]"
New Brunswick Housing Corporation,2023,8,8,8,0,0.0,0.0,0.0,"(-0.001, 10.0]"
New Brunswick Liquor Corporation,2014,2,2,2,0,0.0,0.0,0.0,"(-0.001, 10.0]"
Office of the Attorney General,2014,3,3,3,0,0.0,0.0,0.0,"(-0.001, 10.0]"
Office of the Attorney General,2015,11,11,11,0,0.0,0.0,0.0,"(-0.001, 10.0]"
Office of the Attorney General,2016,11,11,11,0,0.0,0.0,0.0,"(-0.001, 10.0]"
Office of the Attorney General,2017,1,1,1,0,0.0,0.0,0.0,"(-0.001, 10.0]"
Office of the Attorney General,2018,1,1,1,0,0.0,0.0,0.0,"(-0.001, 10.0]"
Office of the Premier,2013,21,16,21,0,0.0,0.0,0.0,"(-0.001, 10.0]"
Office of the Premier,2015,5,5,5,0,0.0,0.0,0.0,"(-0.001, 10.0]"
Office of the Premier,2016,8,8,8,0,0.0,0.0,0.0,"(-0.001, 10.0]"
Office of the Premier,2017,22,13,10,12,54.55,0.923,1.2,"(50.0, 60.0]"
Office of the Premier,2018,1,1,1,0,0.0,0.0,0.0,"(-0.001, 10.0]"
Office of the Premier,2019,12,12,7,5,41.67,0.417,0.714,"(40.0, 50.0]"
Office of the Premier,2020,1,1,0,1,100.0,1.0,,"(90.0, 100.0]"
Office of the Premier,2022,2,2,2,0,0.0,0.0,0.0,"(-0.001, 10.0]"
Office of the Premier,2023,3,3,1,2,66.67,0.667,2.0,"(60.0, 70.0]"
Opportunities New Brunswick,2015,1,1,1,0,0.0,0.0,0.0,"(-0.001, 10.0]"
Opportunities New Brunswick,2017,10,10,10,0,0.0,0.0,0.0,"(-0.001, 10.0]"
Post-Secondary Education Training and Labour,2013,74,74,74,0,0.0,0.0,0.0,"(-0.001, 10.0]"
Post-Secondary Education Training and Labour,2014,26,26,26,0,0.0,0.0,0.0,"(-0.001, 10.0]"
Post-Secondary Education Training and Labour,2015,60,59,59,1,1.67,0.017,0.017,"(-0.001, 10.0]"
Post-Secondary Education Training and Labour,2016,61,59,56,5,8.2,0.085,0.089,"(-0.001, 10.0]"
Post-Secondary Education Training and Labour,2017,52,52,50,2,3.85,0.038,0.04,"(-0.001, 10.0]"
Post-Secondary Education Training and Labour,2018,38,38,37,1,2.63,0.026,0.027,"(-0.001, 10.0]"
Post-Secondary Education Training and Labour,2019,46,45,38,8,17.39,0.178,0.211,"(10.0, 20.0]"
Post-Secondary Education Training and Labour,2020,44,44,37,7,15.91,0.159,0.189,"(10.0, 20.0]"
Post-Secondary Education Training and Labour,2021,43,43,40,3,6.98,0.07,0.075,"(-0.001, 10.0]"
Post-Secondary Education Training and Labour,2022,43,41,39,4,9.3,0.098,0.103,"(-0.001, 10.0]"
Post-Secondary Education Training and Labour,2023,41,41,38,3,7.32,0.073,0.079,"(-0.001, 10.0]"
Post-Secondary Education Training and Labour,2024,25,25,21,4,16.0,0.16,0.19,"(10.0, 20.0]"
Public Safety,2013,35,35,35,0,0.0,0.0,0.0,"(-0.001, 10.0]"
Public Safety,2014,17,16,17,0,0.0,0.0,0.0,"(-0.001, 10.0]"
Public Safety,2015,17,16,15,2,11.76,0.125,0.133,"(10.0, 20.0]"
Public Safety,2016,3,3,3,0,0.0,0.0,0.0,"(-0.001, 10.0]"
Public Safety,2019,71,69,69,2,2.82,0.029,0.029,"(-0.001, 10.0]"
Public Safety,2020,25,25,16,9,36.0,0.36,0.562,"(30.0, 40.0]"
Regional Development Corporation,2015,7,7,7,0,0.0,0.0,0.0,"(-0.001, 10.0]"
Regional Development Corporation,2016,2,2,2,0,0.0,0.0,0.0,"(-0.001, 10.0]"
Regional Development Corporation,2020,1,1,1,0,0.0,0.0,0.0,"(-0.001, 10.0]"
Service New Brunswick,2013,6,5,6,0,0.0,0.0,0.0,"(-0.001, 10.0]"
Service New Brunswick,2015,16,13,16,0,0.0,0.0,0.0,"(-0.001, 10.0]"
Service New Brunswick,2016,2,2,2,0,0.0,0.0,0.0,"(-0.001, 10.0]"
Service New Brunswick,2018,13,12,13,0,0.0,0.0,0.0,"(-0.001, 10.0]"
Service New Brunswick,2019,7,5,7,0,0.0,0.0,0.0,"(-0.001, 10.0]"
Service New Brunswick,2020,2,2,2,0,0.0,0.0,0.0,"(-0.001, 10.0]"
Service New Brunswick,2021,14,11,12,2,14.29,0.182,0.167,"(10.0, 20.0]"
Service New Brunswick,2022,3,3,2,1,33.33,0.333,0.5,"(30.0, 40.0]"
Service New Brunswick,2024,5,4,2,3,60.0,0.75,1.5,"(50.0, 60.0]"
Social Development,2013,3,3,3,0,0.0,0.0,0.0,"(-0.001, 10.0]"
Social Development,2014,15,15,15,0,0.0,0.0,0.0,"(-0.001, 10.0]"
Social Development,2015,9,9,9,0,0.0,0.0,0.0,"(-0.001, 10.0]"
Social Development,2017,21,21,14,7,33.33,0.333,0.5,"(30.0, 40.0]"
Social Development,2018,19,19,18,1,5.26,0.053,0.056,"(-0.001, 10.0]"
Social Development,2019,12,10,12,0,0.0,0.0,0.0,"(-0.001, 10.0]"
Social Development,2020,13,13,13,0,0.0,0.0,0.0,"(-0.001, 10.0]"
Social Development,2021,23,23,21,2,8.7,0.087,0.095,"(-0.001, 10.0]"
Social Development,2022,7,7,7,0,0.0,0.0,0.0,"(-0.001, 10.0]"
Social Development,2023,9,9,9,0,0.0,0.0,0.0,"(-0.001, 10.0]"
Social Development; Service New Brunswick,2023,2,2,2,0,0.0,0.0,0.0,"(-0.001, 10.0]"
"Tourism, Heritage and Culture",2013,3,3,3,0,0.0,0.0,0.0,"(-0.001, 10.0]"
"Tourism, Heritage and Culture",2014,17,17,17,0,0.0,0.0,0.0,"(-0.001, 10.0]"
"Tourism, Heritage and Culture",2015,1,1,1,0,0.0,0.0,0.0,"(-0.001, 10.0]"
"Tourism, Heritage and Culture",2016,4,4,4,0,0.0,0.0,0.0,"(-0.001, 10.0]"
"Tourism, Heritage and Culture",2017,32,32,29,3,9.38,0.094,0.103,"(-0.001, 10.0]"
"Tourism, Heritage and Culture",2018,3,3,3,0,0.0,0.0,0.0,"(-0.001, 10.0]"
"Tourism, Heritage and Culture",2019,20,18,18,2,10.0,0.111,0.111,"(-0.001, 10.0]"
"Tourism, Heritage and Culture",2020,5,5,3,2,40.0,0.4,0.667,"(30.0, 40.0]"
"Tourism, Heritage and Culture",2021,12,12,9,3,25.0,0.25,0.333,"(20.0, 30.0]"
"Tourism, Heritage and Culture",2022,26,24,23,3,11.54,0.125,0.13,"(10.0, 20.0]"
"Tourism, Heritage and Culture",2023,7,7,6,1,14.29,0.143,0.167,"(10.0, 20.0]"
"Tourism, Heritage and Culture",2024,10,10,9,1,10.0,0.1,0.111,"(-0.001, 10.0]"
Transportation,2014,2,2,2,0,0.0,0.0,0.0,"(-0.001, 10.0]"
Transportation and Infrastructure,2016,1,1,1,0,0.0,0.0,0.0,"(-0.001, 10.0]"
Transportation and Infrastructure,2021,2,2,2,0,0.0,0.0,0.0,"(-0.001, 10.0]"
Women's Equality,2024,6,6,6,0,0.0,0.0,0.0,"(-0.001, 10.0]"
