org,year,total_appointments,unique_appointments,unique_positions,reappointments,new_appointments,reappointment_rate
Aboriginal Affairs Secretariat,2018,4,4,1,0,4,0.0
"Agriculture, Aquaculture and Fisheries",2013,20,17,4,0,20,0.0
"Agriculture, Aquaculture and Fisheries",2014,26,17,14,7,19,26.92
"Agriculture, Aquaculture and Fisheries",2015,1,1,1,0,1,0.0
"Agriculture, Aquaculture and Fisheries",2018,33,31,13,2,31,6.06
"Agriculture, Aquaculture and Fisheries",2019,2,2,2,0,2,0.0
"Agriculture, Aquaculture and Fisheries",2021,26,21,6,8,18,30.77
"Agriculture, Aquaculture and Fisheries",2022,9,9,5,3,6,33.33
"Agriculture, Aquaculture and Fisheries",2023,20,20,7,1,19,5.0
"Agriculture, Aquaculture and Fisheries",2024,11,10,4,11,0,100.0
Board of Management,2014,7,7,3,0,7,0.0
Economic Development,2013,9,9,3,0,9,0.0
Economic Development,2014,15,15,6,1,14,6.67
Economic Development,2015,12,11,4,0,12,0.0
Education and Early Childhood Development,2014,16,16,5,0,16,0.0
Education and Early Childhood Development,2016,2,2,1,1,1,50.0
Education and Early Childhood Development,2017,15,15,5,0,15,0.0
Education and Early Childhood Development,2018,1,1,1,1,0,100.0
Education and Early Childhood Development,2019,1,1,1,1,0,100.0
Education and Early Childhood Development,2020,13,11,4,2,11,15.38
Education and Early Childhood Development,2021,1,1,1,0,1,0.0
Education and Early Childhood Development,2022,1,1,1,0,1,0.0
Education and Early Childhood Development,2024,17,17,8,1,16,5.88
Elections New Brunswick,2013,49,48,3,0,49,0.0
Elections New Brunswick,2014,5,5,2,0,5,0.0
Elections New Brunswick,2015,15,15,2,0,15,0.0
Elections New Brunswick,2016,1,1,1,0,1,0.0
Elections New Brunswick,2018,4,4,1,0,4,0.0
Elections New Brunswick,2019,15,15,2,5,10,33.33
Elections New Brunswick,2020,1,1,1,0,1,0.0
Energy Efficiency and Conservation Agency of New Brunswick,2014,5,5,4,0,5,0.0
Energy and Mines,2013,6,6,3,0,6,0.0
Energy and Mines,2014,10,8,5,0,10,0.0
Energy and Mines,2015,7,6,2,0,7,0.0
Energy and Resource Development,2016,4,1,1,3,1,75.0
Energy and Resource Development,2017,2,2,2,0,2,0.0
Energy and Resource Development,2018,13,13,5,0,13,0.0
Energy and Resource Development,2019,17,15,7,0,17,0.0
Energy and Resource Development; Finance,2017,7,7,2,0,7,0.0
Environment and Local Government,2013,16,14,6,1,15,6.25
Environment and Local Government,2014,17,17,13,0,17,0.0
Environment and Local Government,2015,6,6,4,0,6,0.0
Environment and Local Government,2016,14,14,5,0,14,0.0
Environment and Local Government,2017,23,23,7,1,22,4.35
Environment and Local Government,2018,12,12,9,0,12,0.0
Environment and Local Government,2019,16,16,6,3,13,18.75
Environment and Local Government,2020,13,12,8,1,12,7.69
Environment and Local Government,2021,26,24,12,4,22,15.38
Environment and Local Government,2022,8,7,5,2,6,25.0
Environment and Local Government,2023,18,17,10,3,15,16.67
Environment and Local Government,2024,16,14,8,4,12,25.0
Executive Council Office,2013,45,32,35,0,45,0.0
Executive Council Office,2014,25,18,17,2,23,8.0
Executive Council Office,2015,24,17,23,0,24,0.0
Executive Council Office,2016,50,39,34,3,47,6.0
Executive Council Office,2017,99,82,23,12,87,12.12
Executive Council Office,2018,79,48,29,14,65,17.72
Executive Council Office,2019,107,100,33,10,97,9.35
Executive Council Office,2020,84,52,43,10,74,11.9
Executive Council Office,2021,32,31,11,1,31,3.12
Executive Council Office,2022,68,51,25,12,56,17.65
Executive Council Office,2023,58,50,24,18,40,31.03
Executive Council Office,2024,71,45,43,2,69,2.82
Finance,2013,5,5,3,0,5,0.0
Finance,2014,4,4,4,0,4,0.0
Finance,2015,8,6,5,0,8,0.0
Finance,2016,8,8,5,0,8,0.0
Finance,2017,10,10,2,0,10,0.0
Finance,2018,11,11,5,0,11,0.0
Finance,2019,1,1,1,0,1,0.0
Finance,2022,1,1,1,0,1,0.0
Finance and Treasury Board,2019,5,5,2,0,5,0.0
Finance and Treasury Board,2020,15,15,6,0,15,0.0
Finance and Treasury Board,2021,17,17,4,3,14,17.65
Finance and Treasury Board,2022,10,10,4,1,9,10.0
Finance and Treasury Board,2023,15,15,4,7,8,46.67
Finance and Treasury Board,2024,5,5,3,0,5,0.0
Finance; New Brunswick Liquor Corporation,2013,4,4,1,0,4,0.0
Finance; New Brunswick Liquor Corporation,2017,10,9,3,0,10,0.0
Finance; Transportation and Infrastructure,2017,2,2,2,0,2,0.0
Finance; Treasury Board,2019,8,8,3,0,8,0.0
Government Services,2013,2,2,2,0,2,0.0
Government Services,2015,3,3,1,0,3,0.0
Health,2013,27,26,12,1,26,3.7
Health,2014,18,17,9,0,18,0.0
Health,2015,18,18,7,0,18,0.0
Health,2016,39,38,12,4,35,10.26
Health,2017,26,26,13,5,21,19.23
Health,2018,22,22,9,8,14,36.36
Health,2019,32,31,13,6,26,18.75
Health,2020,17,17,9,2,15,11.76
Health,2021,27,26,8,0,27,0.0
Health,2022,20,20,10,3,17,15.0
Health,2023,21,20,12,0,21,0.0
Health,2024,22,22,10,5,17,22.73
Healthy and Inclusive Communities,2013,1,1,1,0,1,0.0
Healthy and Inclusive Communities,2014,10,10,3,0,10,0.0
Healthy and Inclusive Communities,2015,2,2,1,0,2,0.0
Indigenous Affairs,2023,1,1,1,0,1,0.0
Intergovernmental Affairs,2018,2,2,1,0,2,0.0
Intergovernmental Affairs,2021,3,3,2,0,3,0.0
Intergovernmental Affairs,2022,1,1,1,0,1,0.0
Intergovernmental Affairs,2024,2,2,1,0,2,0.0
Justice,2013,3,3,3,0,3,0.0
Justice,2014,144,140,15,0,144,0.0
Justice,2015,61,60,7,15,46,24.59
Justice,2016,9,8,5,0,9,0.0
Justice and Attorney General,2013,30,27,13,2,28,6.67
Justice and Attorney General,2018,7,2,3,1,6,14.29
Justice and Attorney General,2019,16,16,5,0,16,0.0
Justice and Attorney General,2020,7,7,3,0,7,0.0
Justice and Attorney General; Public Safety,2020,6,6,1,0,6,0.0
Justice and Public Safety,2016,29,29,9,0,29,0.0
Justice and Public Safety,2017,94,94,12,0,94,0.0
Justice and Public Safety,2018,31,19,12,0,31,0.0
Justice and Public Safety,2020,21,20,4,0,21,0.0
Justice and Public Safety,2021,31,26,18,5,26,16.13
Justice and Public Safety,2022,13,10,11,0,13,0.0
Justice and Public Safety,2023,15,10,14,0,15,0.0
Justice and Public Safety,2024,55,50,25,1,54,1.82
Natural Resources,2013,11,11,6,0,11,0.0
Natural Resources,2014,9,9,3,0,9,0.0
Natural Resources,2015,5,5,4,0,5,0.0
Natural Resources and Energy Development,2020,9,9,4,0,9,0.0
Natural Resources and Energy Development,2021,9,9,3,0,9,0.0
Natural Resources and Energy Development,2022,11,10,5,0,11,0.0
Natural Resources and Energy Development,2023,7,6,7,1,6,14.29
Natural Resources and Energy Development,2024,17,17,4,3,14,17.65
New Brunswick Housing Corporation,2023,8,8,1,0,8,0.0
New Brunswick Liquor Corporation,2014,2,2,2,0,2,0.0
Office of the Attorney General,2014,3,3,3,0,3,0.0
Office of the Attorney General,2015,11,11,2,0,11,0.0
Office of the Attorney General,2016,11,11,2,0,11,0.0
Office of the Attorney General,2017,1,1,1,0,1,0.0
Office of the Attorney General,2018,1,1,1,0,1,0.0
Office of the Premier,2013,21,16,4,0,21,0.0
Office of the Premier,2015,5,5,1,0,5,0.0
Office of the Premier,2016,8,8,7,0,8,0.0
Office of the Premier,2017,22,13,3,12,10,54.55
Office of the Premier,2018,1,1,1,0,1,0.0
Office of the Premier,2019,12,12,2,5,7,41.67
Office of the Premier,2020,1,1,1,1,0,100.0
Office of the Premier,2022,2,2,2,0,2,0.0
Office of the Premier,2023,3,3,2,2,1,66.67
Opportunities New Brunswick,2015,1,1,1,0,1,0.0
Opportunities New Brunswick,2017,10,10,3,0,10,0.0
Post-Secondary Education Training and Labour,2013,74,74,19,0,74,0.0
Post-Secondary Education Training and Labour,2014,26,26,12,0,26,0.0
Post-Secondary Education Training and Labour,2015,60,59,19,1,59,1.67
Post-Secondary Education Training and Labour,2016,61,59,18,5,56,8.2
Post-Secondary Education Training and Labour,2017,52,52,17,2,50,3.85
Post-Secondary Education Training and Labour,2018,38,38,13,1,37,2.63
Post-Secondary Education Training and Labour,2019,46,45,22,8,38,17.39
Post-Secondary Education Training and Labour,2020,44,44,14,7,37,15.91
Post-Secondary Education Training and Labour,2021,43,43,12,3,40,6.98
Post-Secondary Education Training and Labour,2022,43,41,12,4,39,9.3
Post-Secondary Education Training and Labour,2023,41,41,10,3,38,7.32
Post-Secondary Education Training and Labour,2024,25,25,8,4,21,16.0
Public Safety,2013,35,35,6,0,35,0.0
Public Safety,2014,17,16,5,0,17,0.0
Public Safety,2015,17,16,5,2,15,11.76
Public Safety,2016,3,3,2,0,3,0.0
Public Safety,2019,71,69,11,2,69,2.82
Public Safety,2020,25,25,5,9,16,36.0
Regional Development Corporation,2015,7,7,1,0,7,0.0
Regional Development Corporation,2016,2,2,1,0,2,0.0
Regional Development Corporation,2020,1,1,1,0,1,0.0
Service New Brunswick,2013,6,5,2,0,6,0.0
Service New Brunswick,2015,16,13,7,0,16,0.0
Service New Brunswick,2016,2,2,2,0,2,0.0
Service New Brunswick,2018,13,12,6,0,13,0.0
Service New Brunswick,2019,7,5,6,0,7,0.0
Service New Brunswick,2020,2,2,1,0,2,0.0
Service New Brunswick,2021,14,11,8,2,12,14.29
Service New Brunswick,2022,3,3,3,1,2,33.33
Service New Brunswick,2024,5,4,2,3,2,60.0
Social Development,2013,3,3,1,0,3,0.0
Social Development,2014,15,15,3,0,15,0.0
Social Development,2015,9,9,3,0,9,0.0
Social Development,2017,21,21,5,7,14,33.33
Social Development,2018,19,19,4,1,18,5.26
Social Development,2019,12,10,5,0,12,0.0
Social Development,2020,13,13,3,0,13,0.0
Social Development,2021,23,23,4,2,21,8.7
Social Development,2022,7,7,3,0,7,0.0
Social Development,2023,9,9,3,0,9,0.0
Social Development; Service New Brunswick,2023,2,2,2,0,2,0.0
"Tourism, Heritage and Culture",2013,3,3,1,0,3,0.0
"Tourism, Heritage and Culture",2014,17,17,3,0,17,0.0
"Tourism, Heritage and Culture",2015,1,1,1,0,1,0.0
"Tourism, Heritage and Culture",2016,4,4,2,0,4,0.0
"Tourism, Heritage and Culture",2017,32,32,10,3,29,9.38
"Tourism, Heritage and Culture",2018,3,3,2,0,3,0.0
"Tourism, Heritage and Culture",2019,20,18,5,2,18,10.0
"Tourism, Heritage and Culture",2020,5,5,3,2,3,40.0
"Tourism, Heritage and Culture",2021,12,12,3,3,9,25.0
"Tourism, Heritage and Culture",2022,26,24,6,3,23,11.54
"Tourism, Heritage and Culture",2023,7,7,3,1,6,14.29
"Tourism, Heritage and Culture",2024,10,10,5,1,9,10.0
Transportation,2014,2,2,1,0,2,0.0
Transportation and Infrastructure,2016,1,1,1,0,1,0.0
Transportation and Infrastructure,2021,2,2,1,0,2,0.0
Women's Equality,2024,6,6,2,0,6,0.0
