org,year,total_employees,reappointment_count,reappointment_rate,new_appointments,new_appointment_rate,rate_bin
Aboriginal Affairs Secretariat,2018,4,0,0.0,4,100.0,"(-0.001, 10.0]"
"Agriculture, Aquaculture and Fisheries",2013,20,0,0.0,20,100.0,"(-0.001, 10.0]"
"Agriculture, Aquaculture and Fisheries",2014,26,7,26.92,19,73.08,"(20.0, 30.0]"
"Agriculture, Aquaculture and Fisheries",2015,1,0,0.0,1,100.0,"(-0.001, 10.0]"
"Agriculture, Aquaculture and Fisheries",2018,33,2,6.06,31,93.94,"(-0.001, 10.0]"
"Agriculture, Aquaculture and Fisheries",2019,2,0,0.0,2,100.0,"(-0.001, 10.0]"
"Agriculture, Aquaculture and Fisheries",2021,26,8,30.77,18,69.23,"(30.0, 40.0]"
"Agriculture, Aquaculture and Fisheries",2022,9,3,33.33,6,66.67,"(30.0, 40.0]"
"Agriculture, Aquaculture and Fisheries",2023,20,1,5.0,19,95.0,"(-0.001, 10.0]"
"Agriculture, Aquaculture and Fisheries",2024,11,11,100.0,0,0.0,"(90.0, 100.0]"
Board of Management,2014,7,0,0.0,7,100.0,"(-0.001, 10.0]"
Economic Development,2013,9,0,0.0,9,100.0,"(-0.001, 10.0]"
Economic Development,2014,15,1,6.67,14,93.33,"(-0.001, 10.0]"
Economic Development,2015,12,0,0.0,12,100.0,"(-0.001, 10.0]"
Education and Early Childhood Development,2014,16,0,0.0,16,100.0,"(-0.001, 10.0]"
Education and Early Childhood Development,2016,2,1,50.0,1,50.0,"(40.0, 50.0]"
Education and Early Childhood Development,2017,15,0,0.0,15,100.0,"(-0.001, 10.0]"
Education and Early Childhood Development,2018,1,1,100.0,0,0.0,"(90.0, 100.0]"
Education and Early Childhood Development,2019,1,1,100.0,0,0.0,"(90.0, 100.0]"
Education and Early Childhood Development,2020,13,2,15.38,11,84.62,"(10.0, 20.0]"
Education and Early Childhood Development,2021,1,0,0.0,1,100.0,"(-0.001, 10.0]"
Education and Early Childhood Development,2022,1,0,0.0,1,100.0,"(-0.001, 10.0]"
Education and Early Childhood Development,2024,17,1,5.88,16,94.12,"(-0.001, 10.0]"
Elections New Brunswick,2013,49,0,0.0,49,100.0,"(-0.001, 10.0]"
Elections New Brunswick,2014,5,0,0.0,5,100.0,"(-0.001, 10.0]"
Elections New Brunswick,2015,15,0,0.0,15,100.0,"(-0.001, 10.0]"
Elections New Brunswick,2016,1,0,0.0,1,100.0,"(-0.001, 10.0]"
Elections New Brunswick,2018,4,0,0.0,4,100.0,"(-0.001, 10.0]"
Elections New Brunswick,2019,15,5,33.33,10,66.67,"(30.0, 40.0]"
Elections New Brunswick,2020,1,0,0.0,1,100.0,"(-0.001, 10.0]"
Energy Efficiency and Conservation Agency of New Brunswick,2014,5,0,0.0,5,100.0,"(-0.001, 10.0]"
Energy and Mines,2013,6,0,0.0,6,100.0,"(-0.001, 10.0]"
Energy and Mines,2014,10,0,0.0,10,100.0,"(-0.001, 10.0]"
Energy and Mines,2015,7,0,0.0,7,100.0,"(-0.001, 10.0]"
Energy and Resource Development,2016,4,3,75.0,1,25.0,"(70.0, 80.0]"
Energy and Resource Development,2017,2,0,0.0,2,100.0,"(-0.001, 10.0]"
Energy and Resource Development,2018,13,0,0.0,13,100.0,"(-0.001, 10.0]"
Energy and Resource Development,2019,17,0,0.0,17,100.0,"(-0.001, 10.0]"
Energy and Resource Development; Finance,2017,7,0,0.0,7,100.0,"(-0.001, 10.0]"
Environment and Local Government,2013,16,1,6.25,15,93.75,"(-0.001, 10.0]"
Environment and Local Government,2014,17,0,0.0,17,100.0,"(-0.001, 10.0]"
Environment and Local Government,2015,6,0,0.0,6,100.0,"(-0.001, 10.0]"
Environment and Local Government,2016,14,0,0.0,14,100.0,"(-0.001, 10.0]"
Environment and Local Government,2017,23,1,4.35,22,95.65,"(-0.001, 10.0]"
Environment and Local Government,2018,12,0,0.0,12,100.0,"(-0.001, 10.0]"
Environment and Local Government,2019,16,3,18.75,13,81.25,"(10.0, 20.0]"
Environment and Local Government,2020,13,1,7.69,12,92.31,"(-0.001, 10.0]"
Environment and Local Government,2021,26,4,15.38,22,84.62,"(10.0, 20.0]"
Environment and Local Government,2022,8,2,25.0,6,75.0,"(20.0, 30.0]"
Environment and Local Government,2023,18,3,16.67,15,83.33,"(10.0, 20.0]"
Environment and Local Government,2024,16,4,25.0,12,75.0,"(20.0, 30.0]"
Executive Council Office,2013,45,0,0.0,45,100.0,"(-0.001, 10.0]"
Executive Council Office,2014,25,2,8.0,23,92.0,"(-0.001, 10.0]"
Executive Council Office,2015,24,0,0.0,24,100.0,"(-0.001, 10.0]"
Executive Council Office,2016,50,3,6.0,47,94.0,"(-0.001, 10.0]"
Executive Council Office,2017,99,12,12.12,87,87.88,"(10.0, 20.0]"
Executive Council Office,2018,79,14,17.72,65,82.28,"(10.0, 20.0]"
Executive Council Office,2019,107,10,9.35,97,90.65,"(-0.001, 10.0]"
Executive Council Office,2020,84,10,11.9,74,88.1,"(10.0, 20.0]"
Executive Council Office,2021,32,1,3.12,31,96.88,"(-0.001, 10.0]"
Executive Council Office,2022,68,12,17.65,56,82.35,"(10.0, 20.0]"
Executive Council Office,2023,58,18,31.03,40,68.97,"(30.0, 40.0]"
Executive Council Office,2024,71,2,2.82,69,97.18,"(-0.001, 10.0]"
Finance,2013,5,0,0.0,5,100.0,"(-0.001, 10.0]"
Finance,2014,4,0,0.0,4,100.0,"(-0.001, 10.0]"
Finance,2015,8,0,0.0,8,100.0,"(-0.001, 10.0]"
Finance,2016,8,0,0.0,8,100.0,"(-0.001, 10.0]"
Finance,2017,10,0,0.0,10,100.0,"(-0.001, 10.0]"
Finance,2018,11,0,0.0,11,100.0,"(-0.001, 10.0]"
Finance,2019,1,0,0.0,1,100.0,"(-0.001, 10.0]"
Finance,2022,1,0,0.0,1,100.0,"(-0.001, 10.0]"
Finance and Treasury Board,2019,5,0,0.0,5,100.0,"(-0.001, 10.0]"
Finance and Treasury Board,2020,15,0,0.0,15,100.0,"(-0.001, 10.0]"
Finance and Treasury Board,2021,17,3,17.65,14,82.35,"(10.0, 20.0]"
Finance and Treasury Board,2022,10,1,10.0,9,90.0,"(-0.001, 10.0]"
Finance and Treasury Board,2023,15,7,46.67,8,53.33,"(40.0, 50.0]"
Finance and Treasury Board,2024,5,0,0.0,5,100.0,"(-0.001, 10.0]"
Finance; New Brunswick Liquor Corporation,2013,4,0,0.0,4,100.0,"(-0.001, 10.0]"
Finance; New Brunswick Liquor Corporation,2017,10,0,0.0,10,100.0,"(-0.001, 10.0]"
Finance; Transportation and Infrastructure,2017,2,0,0.0,2,100.0,"(-0.001, 10.0]"
Finance; Treasury Board,2019,8,0,0.0,8,100.0,"(-0.001, 10.0]"
Government Services,2013,2,0,0.0,2,100.0,"(-0.001, 10.0]"
Government Services,2015,3,0,0.0,3,100.0,"(-0.001, 10.0]"
Health,2013,27,1,3.7,26,96.3,"(-0.001, 10.0]"
Health,2014,18,0,0.0,18,100.0,"(-0.001, 10.0]"
Health,2015,18,0,0.0,18,100.0,"(-0.001, 10.0]"
Health,2016,39,4,10.26,35,89.74,"(10.0, 20.0]"
Health,2017,26,5,19.23,21,80.77,"(10.0, 20.0]"
Health,2018,22,8,36.36,14,63.64,"(30.0, 40.0]"
Health,2019,32,6,18.75,26,81.25,"(10.0, 20.0]"
Health,2020,17,2,11.76,15,88.24,"(10.0, 20.0]"
Health,2021,27,0,0.0,27,100.0,"(-0.001, 10.0]"
Health,2022,20,3,15.0,17,85.0,"(10.0, 20.0]"
Health,2023,21,0,0.0,21,100.0,"(-0.001, 10.0]"
Health,2024,22,5,22.73,17,77.27,"(20.0, 30.0]"
Healthy and Inclusive Communities,2013,1,0,0.0,1,100.0,"(-0.001, 10.0]"
Healthy and Inclusive Communities,2014,10,0,0.0,10,100.0,"(-0.001, 10.0]"
Healthy and Inclusive Communities,2015,2,0,0.0,2,100.0,"(-0.001, 10.0]"
Indigenous Affairs,2023,1,0,0.0,1,100.0,"(-0.001, 10.0]"
Intergovernmental Affairs,2018,2,0,0.0,2,100.0,"(-0.001, 10.0]"
Intergovernmental Affairs,2021,3,0,0.0,3,100.0,"(-0.001, 10.0]"
Intergovernmental Affairs,2022,1,0,0.0,1,100.0,"(-0.001, 10.0]"
Intergovernmental Affairs,2024,2,0,0.0,2,100.0,"(-0.001, 10.0]"
Justice,2013,3,0,0.0,3,100.0,"(-0.001, 10.0]"
Justice,2014,144,0,0.0,144,100.0,"(-0.001, 10.0]"
Justice,2015,61,15,24.59,46,75.41,"(20.0, 30.0]"
Justice,2016,9,0,0.0,9,100.0,"(-0.001, 10.0]"
Justice and Attorney General,2013,30,1,3.33,29,96.67,"(-0.001, 10.0]"
Justice and Attorney General,2018,7,1,14.29,6,85.71,"(10.0, 20.0]"
Justice and Attorney General,2019,16,0,0.0,16,100.0,"(-0.001, 10.0]"
Justice and Attorney General,2020,7,0,0.0,7,100.0,"(-0.001, 10.0]"
Justice and Attorney General; Public Safety,2020,6,0,0.0,6,100.0,"(-0.001, 10.0]"
Justice and Public Safety,2016,29,0,0.0,29,100.0,"(-0.001, 10.0]"
Justice and Public Safety,2017,94,0,0.0,94,100.0,"(-0.001, 10.0]"
Justice and Public Safety,2018,31,0,0.0,31,100.0,"(-0.001, 10.0]"
Justice and Public Safety,2020,21,0,0.0,21,100.0,"(-0.001, 10.0]"
Justice and Public Safety,2021,31,5,16.13,26,83.87,"(10.0, 20.0]"
Justice and Public Safety,2022,13,0,0.0,13,100.0,"(-0.001, 10.0]"
Justice and Public Safety,2023,15,0,0.0,15,100.0,"(-0.001, 10.0]"
Justice and Public Safety,2024,55,1,1.82,54,98.18,"(-0.001, 10.0]"
Natural Resources,2013,11,0,0.0,11,100.0,"(-0.001, 10.0]"
Natural Resources,2014,9,0,0.0,9,100.0,"(-0.001, 10.0]"
Natural Resources,2015,5,0,0.0,5,100.0,"(-0.001, 10.0]"
Natural Resources and Energy Development,2020,9,0,0.0,9,100.0,"(-0.001, 10.0]"
Natural Resources and Energy Development,2021,9,0,0.0,9,100.0,"(-0.001, 10.0]"
Natural Resources and Energy Development,2022,11,0,0.0,11,100.0,"(-0.001, 10.0]"
Natural Resources and Energy Development,2023,7,1,14.29,6,85.71,"(10.0, 20.0]"
Natural Resources and Energy Development,2024,17,3,17.65,14,82.35,"(10.0, 20.0]"
New Brunswick Housing Corporation,2023,8,0,0.0,8,100.0,"(-0.001, 10.0]"
New Brunswick Liquor Corporation,2014,2,0,0.0,2,100.0,"(-0.001, 10.0]"
Office of the Attorney General,2014,3,0,0.0,3,100.0,"(-0.001, 10.0]"
Office of the Attorney General,2015,11,0,0.0,11,100.0,"(-0.001, 10.0]"
Office of the Attorney General,2016,11,0,0.0,11,100.0,"(-0.001, 10.0]"
Office of the Attorney General,2017,1,0,0.0,1,100.0,"(-0.001, 10.0]"
Office of the Attorney General,2018,1,0,0.0,1,100.0,"(-0.001, 10.0]"
Office of the Premier,2013,21,0,0.0,21,100.0,"(-0.001, 10.0]"
Office of the Premier,2015,5,0,0.0,5,100.0,"(-0.001, 10.0]"
Office of the Premier,2016,8,0,0.0,8,100.0,"(-0.001, 10.0]"
Office of the Premier,2017,22,12,54.55,10,45.45,"(50.0, 60.0]"
Office of the Premier,2018,1,0,0.0,1,100.0,"(-0.001, 10.0]"
Office of the Premier,2019,12,5,41.67,7,58.33,"(40.0, 50.0]"
Office of the Premier,2020,1,1,100.0,0,0.0,"(90.0, 100.0]"
Office of the Premier,2022,2,0,0.0,2,100.0,"(-0.001, 10.0]"
Office of the Premier,2023,3,2,66.67,1,33.33,"(60.0, 70.0]"
Opportunities New Brunswick,2015,1,0,0.0,1,100.0,"(-0.001, 10.0]"
Opportunities New Brunswick,2017,10,0,0.0,10,100.0,"(-0.001, 10.0]"
Post-Secondary Education Training and Labour,2013,74,0,0.0,74,100.0,"(-0.001, 10.0]"
Post-Secondary Education Training and Labour,2014,26,0,0.0,26,100.0,"(-0.001, 10.0]"
Post-Secondary Education Training and Labour,2015,60,1,1.67,59,98.33,"(-0.001, 10.0]"
Post-Secondary Education Training and Labour,2016,61,5,8.2,56,91.8,"(-0.001, 10.0]"
Post-Secondary Education Training and Labour,2017,52,2,3.85,50,96.15,"(-0.001, 10.0]"
Post-Secondary Education Training and Labour,2018,38,1,2.63,37,97.37,"(-0.001, 10.0]"
Post-Secondary Education Training and Labour,2019,46,8,17.39,38,82.61,"(10.0, 20.0]"
Post-Secondary Education Training and Labour,2020,44,7,15.91,37,84.09,"(10.0, 20.0]"
Post-Secondary Education Training and Labour,2021,43,3,6.98,40,93.02,"(-0.001, 10.0]"
Post-Secondary Education Training and Labour,2022,43,4,9.3,39,90.7,"(-0.001, 10.0]"
Post-Secondary Education Training and Labour,2023,41,3,7.32,38,92.68,"(-0.001, 10.0]"
Post-Secondary Education Training and Labour,2024,25,4,16.0,21,84.0,"(10.0, 20.0]"
Public Safety,2013,35,0,0.0,35,100.0,"(-0.001, 10.0]"
Public Safety,2014,17,0,0.0,17,100.0,"(-0.001, 10.0]"
Public Safety,2015,17,2,11.76,15,88.24,"(10.0, 20.0]"
Public Safety,2016,3,0,0.0,3,100.0,"(-0.001, 10.0]"
Public Safety,2019,71,2,2.82,69,97.18,"(-0.001, 10.0]"
Public Safety,2020,25,9,36.0,16,64.0,"(30.0, 40.0]"
Regional Development Corporation,2015,7,0,0.0,7,100.0,"(-0.001, 10.0]"
Regional Development Corporation,2016,2,0,0.0,2,100.0,"(-0.001, 10.0]"
Regional Development Corporation,2020,1,0,0.0,1,100.0,"(-0.001, 10.0]"
Service New Brunswick,2013,6,0,0.0,6,100.0,"(-0.001, 10.0]"
Service New Brunswick,2015,16,0,0.0,16,100.0,"(-0.001, 10.0]"
Service New Brunswick,2016,2,0,0.0,2,100.0,"(-0.001, 10.0]"
Service New Brunswick,2018,13,0,0.0,13,100.0,"(-0.001, 10.0]"
Service New Brunswick,2019,7,0,0.0,7,100.0,"(-0.001, 10.0]"
Service New Brunswick,2020,2,0,0.0,2,100.0,"(-0.001, 10.0]"
Service New Brunswick,2021,14,2,14.29,12,85.71,"(10.0, 20.0]"
Service New Brunswick,2022,3,1,33.33,2,66.67,"(30.0, 40.0]"
Service New Brunswick,2024,5,3,60.0,2,40.0,"(50.0, 60.0]"
Social Development,2013,3,0,0.0,3,100.0,"(-0.001, 10.0]"
Social Development,2014,15,0,0.0,15,100.0,"(-0.001, 10.0]"
Social Development,2015,9,0,0.0,9,100.0,"(-0.001, 10.0]"
Social Development,2017,21,7,33.33,14,66.67,"(30.0, 40.0]"
Social Development,2018,19,1,5.26,18,94.74,"(-0.001, 10.0]"
Social Development,2019,12,0,0.0,12,100.0,"(-0.001, 10.0]"
Social Development,2020,13,0,0.0,13,100.0,"(-0.001, 10.0]"
Social Development,2021,23,2,8.7,21,91.3,"(-0.001, 10.0]"
Social Development,2022,7,0,0.0,7,100.0,"(-0.001, 10.0]"
Social Development,2023,9,0,0.0,9,100.0,"(-0.001, 10.0]"
Social Development; Service New Brunswick,2023,2,0,0.0,2,100.0,"(-0.001, 10.0]"
"Tourism, Heritage and Culture",2013,3,0,0.0,3,100.0,"(-0.001, 10.0]"
"Tourism, Heritage and Culture",2014,17,0,0.0,17,100.0,"(-0.001, 10.0]"
"Tourism, Heritage and Culture",2015,1,0,0.0,1,100.0,"(-0.001, 10.0]"
"Tourism, Heritage and Culture",2016,4,0,0.0,4,100.0,"(-0.001, 10.0]"
"Tourism, Heritage and Culture",2017,32,3,9.38,29,90.62,"(-0.001, 10.0]"
"Tourism, Heritage and Culture",2018,3,0,0.0,3,100.0,"(-0.001, 10.0]"
"Tourism, Heritage and Culture",2019,20,2,10.0,18,90.0,"(-0.001, 10.0]"
"Tourism, Heritage and Culture",2020,5,2,40.0,3,60.0,"(30.0, 40.0]"
"Tourism, Heritage and Culture",2021,12,3,25.0,9,75.0,"(20.0, 30.0]"
"Tourism, Heritage and Culture",2022,26,3,11.54,23,88.46,"(10.0, 20.0]"
"Tourism, Heritage and Culture",2023,7,1,14.29,6,85.71,"(10.0, 20.0]"
"Tourism, Heritage and Culture",2024,10,1,10.0,9,90.0,"(-0.001, 10.0]"
Transportation,2014,2,0,0.0,2,100.0,"(-0.001, 10.0]"
Transportation and Infrastructure,2016,1,0,0.0,1,100.0,"(-0.001, 10.0]"
Transportation and Infrastructure,2021,2,0,0.0,2,100.0,"(-0.001, 10.0]"
Women's Equality,2024,6,0,0.0,6,100.0,"(-0.001, 10.0]"
